%%%%%%%
%P   P%
% %%% %
%  %  %
%%   %%
%. %%%%
%%%%%%%
